##########
#        #
##### ####
#   #  ###
# ####   #
#    # ###
## ###   #
#  ### # #
#      # #
##########

Skeleton,1,7
Sword,8,8
Key,3,3,KEY0
Door,9,4,room1,1,4,KEY0
